..................
.S.##.##.#..##.##.
..###########.###.
.###.....#.######.
.#.###.##..##.###.
.#.####.###..####.
.######.#########.
.##.##.##..#.####.
...##.#####.###.#.
.####.##.##.#.#...
.##..#####G##..##.
.###...G##.####.#.
.#..#.#.###.##..#.
.##.##..####.####.
...#.######..##...
.....######.#.##..
..####.###.##.#...
.###.#.####.####G.
.#.#.###.#..####..
.##.#######.#.#.#.
..................
