................
.S#.######..#.#.
...##.#####G##..
.####.##..####..
.####.####...#..
..######.######.
.###.##.####.##.
..####G.##..##..
..#.#..#.##.#.#.
.#######.####.#.
.#.########..##.
..####.##.####..
.#####.#######..
..#.######..##..
.##...######.##.
.###G.#########.
.#.##.#.#..##.#.
................
