.................
..#.#S###..#####.
.#.#######.#.....
.#.#..#.#..#..##.
.########....#.#.
.###..######.#...
..#.########.###.
.###.#####.##.#..
.#.#########.##..
.#####..##..####.
..#####..#..#..#.
.......##.#.#.##.
.##..#....#.##.#.
..#...#.####...#.
.....###...#####.
.###.###.##...#..
.###.##..####.##.
..######.####..#.
.................
