........................
.S#..##.###..##########.
.####.#.####.#.#...#.##.
.#.#...####...########..
..###.#.#.#..######.....
.####.####.###..#.#####.
..#..#.#..####..##.####.
.###.##.#..#.#..#.#.#.#.
..#####.#..###.#..####..
.#...##.##.#.#.##.#.#.#.
.#####.#######..###.###.
.#####..###....###.#.##.
.##...#..##..######..#..
.#.###.###..#.#######.#.
.#..#####..#..####.###..
.####.####.#####...####.
........................
