...........................
...#####.#.##.####...##....
.##.#.####..###.##..##.##..
.####.#.###.#.##..#.#.#.##.
..##.#..###.#.####...###.#.
.#...##.##...#...#.###.###.
.#...######...####.##.#.##.
..###.#....##.#..##.###....
.#.###.##...#.####.#.#.###.
.##...##..####.#.##.##.##..
.######..##..#....#..#.###.
...###...##########.####.#.
.#..##.##.#..##...#####.#..
.#..#.########.#..#####.#..
....##..###...####.###.###.
.##.##...##..##..#...#.#.#.
.##..##.#.##.#..##.####....
.###...####.###.#.#.#.####.
..##.#########....#.#...##.
.##.#.#####.#..#.####....#.
.##.##..###...##.###.#####.
.#.#.####.#.######.#####.#.
...#..##.######..###....#..
.####.#..###.#.####..#..##.
...........................
