.............
.S.#########.
..####.#.#.#.
.#.#..#..#...
..###.##.###.
..######..##.
.###..######.
.#....##.###.
..##.##.##...
..####..##.#.
.#....######.
.#.####.#.#..
.#####.#.#.#.
.####.##.###.
...#.#..####.
.#..###....#.
..#######..#.
.#.#..##..#..
..##.##.##.#.
.............
