.............
..##.#.####..
..##.####.##.
..###.#.##.#.
.##.##.#.#.#.
...####.####.
..####.#..##.
...#..#.##...
..##..#.#.##.
.######.####.
.###.##....#.
...#######.#.
...#####.##..
.#.#..###.##.
.#.###...#.#.
....###.#....
.#.##.#.####.
.###.##..##..
.#....####.#.
.............
