S#.######..#.#
..##.#####G##.
####.##..####.
####.####...#.
.######.######
###.##.####.##
.####G.##..##.
.#.#..#.##.#.#
#######.####.#
#.########..##
.####.##.####.
#####.#######.
.#.######..##.
##...######.##
###G.#########
#.##.#.#..##.#
..............