.......................
.###.#################.
.######.########.####..
.##.#######.##########.
.#####.########.######.
.###########.#########.
.#######.#############.
.......................