S.##.##.#..##.##
.###########.###
###.....#.######
#.###.##..##.###
#.####.###..####
######.#########
##.##.##..#.####
..##.#####.###.#
####.##.##.#.#..
##..#####G##..##
###...G##.####.#
#..#.#.###.##..#
##.##..####.####
..#.######..##..
....######.#.##.
.####.###.##.#..
###.#.####.####G
#.#.###.#..####.
##.#######.#.#.#
................