..S#..###.###..##.#.#####
###.#..G.#.##.#.#####.###
#.##.######....######.#.#
.#.#########.#.#######.##
##...###.####.######...#.
###.#.#####.G##..##.##.##
#...#GG######..###...####
##.###.########..######.#
#####.###.##.##.###.##..#
#.#.######...##..#.######
#.##.#..#G#.#..#.####.#..
##...###..#.##.#.#...##.#
###.#...#.####..##.#.#.##
#.####.##.#.###.###....#.
.###.###.#...#..###.####.
.........................