S.#########
.####.#.#.#
#.#..#..#..
.###.##.###
.######..##
###..######
#....##.###
.##.##.##..
.####..##.#
#....######
#.####.#.#.
#####.#.#.#
####.##.###
..#.#..####
#..###....#
.#######..#
#.#..##..#.
.##.##.##.#
...........