.#.####.##.
.##.#.####.
.##.####.##
.###.#.##.#
##.##.#.#.#
..####.####
.####.#..##
..#..#.##..
.##..#.#.##
######.####
###.##....#
..#######.#
..#####.##.
#.#..###.##
#.###...#.#
...###.#...
#.##.#.####
###.##..##.
#....####.#
...........