.....#######...........
.#####################.
#######################
.#####################.
.#####################.
.#####################.
.#####################.
.....##########........