#####..#..#.####.#..#####
..#####.#.##.####...##...
##.#.####..###.##..##.##.
####.#.###.#.##..#.#.#.##
.##.#..###.#.####...###.#
#...##.##...#...#.###.###
#...######...####.##.#.##
.###.#....##.#..##.###...
#.###.##...#.####.#.#.###
##...##..####.#.##.##.##.
######..##..#....#..#.###
..###...##########.####.#
#..##.##.#..##...#####.#.
#..#.########.#..#####.#.
...##..###...####.###.###
##.##...##..##..#...#.#.#
##..##.#.##.#..##.####...
###...####.###.#.#.#.####
.##.#########....#.#...##
##.#.#####.#..#.####....#
##.##..###...##.###.#####
#.#.####.#.######.#####.#
..#..##.######..###....#.
####.#..###.#.####..#..##
.........................