S#..##.###..##########
####.#.####.#.#...#.##
#.#...####...########.
.###.#.#.#..######....
####.####.###..#.#####
.#..#.#..####..##.####
###.##.#..#.#..#.#.#.#
.#####.#..###.#..####.
#...##.##.#.#.##.#.#.#
#####.#######..###.###
#####..###....###.#.##
##...#..##..######..#.
#.###.###..#.#######.#
#..#####..#..####.###.
####.####.#####...####
......................