.#.#S###..#####
#.#######.#....
#.#..#.#..#..##
########....#.#
###..######.#..
.#.########.###
###.#####.##.#.
#.#########.##.
#####..##..####
.#####..#..#..#
......##.#.#.##
##..#....#.##.#
.#...#.####...#
....###...#####
###.###.##...#.
###.##..####.##
.######.####..#
...............